|-----------------------------------------------------------------------------|
|                                                                             |
|   |--------------------|                        |----------------------|    |
|   |....................|                        |......................|    |
|   |....................|                        |......................|    |
|   |....................+########################+......................|    |
|   |....................|           #            |......................|    |
|   |....................|           #            |......................|    |
|   |--------+-----------|           #            |----------+-----------|    |
|            #                       #                       #                |
|            #           |-----------+------------|          #                |
|            #           |........................|          #                |
|            #           |........................|          #                |
|          ##############+........................+#############              |
|            #           |........................|          #                |
|            #           |........................|          #                |
|            #           |-----------+------------|          #                |
|            #                       #                       #                |
|   |--------+-----------|           #             |---------+------------|   |
|   |....................|           #             |......................|   |
|   |....................+#########################+......................|   |
|   |....................|                         |......................|   |
|   |....................|                         |......................|   |
|   |--------------------|                         |----------------------|   |
|-----------------------------------------------------------------------------|       