|-----------------------------------------------------------------------------|
| |---------|      |--------|        |---------|      |---------|     |----|  |
| |.........|      |........|        |.........+##### |.........|     |....|-||
| |.........|      |........|        |.........|   #  |.........|     |......||
| |.........|-|    |......|-|  #   |-|.........|   #  |.........|   |-|......||
| |...........|  # |......|    ####+...........|   #  |.........|   |........|| 
| |...........+### |......|    #   |...........|   #  |.........|   |........||
| |...........|  # |..... |    #   |-----------|   ###+.......|-|   |........||
| |...........|  # |......|    #                      |.......|   |-|........||
| |...........|  # |......|    # #########          |-|.......|   |..........||
| |.......|---|  ##+......|----+---|    #       |---|.........| ##+.......|--|| 
| |.......|      # |...............|    #       |.........|---| # |.......|   |
| |.......|      # |...............|    #       |.........|     # |.......|   |
| |.......|      # |...............|    #       |.........|     # |.......|   |
| |.......|  ##### |...............|    #####   |.........|    ## |.......|   |
| |.......|   #    |...............|       #    |---------|    #  |.......|   |
| |.......|   #    |...............|       #                   #  |.......|   |
| |.......|   #    |-------+-------|       #####################  |.......|   |
| |.......+####            #                       #              |.......|   |
| |.......|   #######################################             |.......|   |
| |-------|                             #               |---------|.......|   |
|                                       #            |--|.................|   |
|                                       #############+....................|   |
|                                                    |--------------------|   |
|-----------------------------------------------------------------------------|